###########################################
#-----------------------------#-----------#
#-C------P--------------------M-----------###
#-----------------------------#-------------#
#-------------########--------####----------#
#-------------#--C-#M---------#D-#----------#
#-------------#---------------#--#----------#
###-----------##############--##-#----------#
  #-----------------C#     #--#C------------#
  ####################     ##################










