###########################################
#.............................#...........#
#.G......P....................M...........###
#.............................#.............#
#.............########........####..........#
#.............#..G.#M.........#D.#..........#
#.............#...............#..#..........#
###...........##############..##.#..........#
  #.................G#     #..#G............#
  ####################     ##################










