#################################
#-------------------------------#
#-C-----------------------------#
#-M-----------M-----------------#
#-------------########----------#
#-------------#--D-#------------#
#-------------#-----C#----------#
#-------------########----------#
#-P---------------#C------------#
#################################
