#################################
#-------------------------------#
#-G-----------------------------#
#-M-----------M-----------------#
#-------------########----------#
#-------------#--D-#------------#
#-------------#-----G#----------#
#-------------########----------#
#-S---------------#G------------#
#################################
