###############################
#.............................#
#.G...........................#
#.............................#
#.............########........#
#.............#..D.#M.........#
#.............#...............#
#.............########........#
#P...............G#G..........#
###############################
